
┌───────────────────────────────────────────────────┐
│    ┌───────────┐    ┌──────────┐   ┌──────────┐   │    () You
│    │ Sector 1  │    │  Sector 2│   │ Sector 3 │   │
│    |           │    |          │   \          │   │    H - Harpoon
│    │           │    │          │   │ ()       │   │
│    │           │    │          │   │          │   │    B - Blaster
│    │           │    │          │   │          │   │
│    │           │    │          │   │  H     P │   │    T - Tablet
│    └───────────┘    └──────────┘   └──────────┘   │
│                                                   │    N - Neuralyzer
│    ┌───────────┐    ┌──────────┐   ┌──────────┐   │
│    │ Sector 4  │    │  Sector 5│   │  Sector 6│   │    P - Potion
│    │           │    │          │   │          │   │
│    │           │    │          │   │          │   │
│    │           │    │          │   │          │   │
│    │           │    │          │   │          │   │
│    │           │    │          │   │          │   │
│    │           │    │          │   │          │   │
│    └───────────┘    └──────────┘   └──────────┘   │
└───────────────────────────────────────────────────┘